#####
#...#
#+#.#
#.#.#
#+###
