###+###
#.#.#.#
#.#.#+#
#.....#
#####.#
#...+.#
#####+#
