#+###
#...#
###.#
#.+.#
#####
