.T.....T.
####+####
#....#..#
#....#..#
#..####.#
#.....+.#
#####.###
#...+.+.#
#####+###
