##................####................##
########################################
.#....................................#.
.#....................................#.
.#..######..#############..#########..#.
.#..#....#..#...........#..#.....#.#..#.
.#..#....+..#...........#..#.....#+#..#.
.#..######..##+######+###..#.......#..#.
.#.........................+.......#..#.
.#..######..#######+##.....#+#######..#.
##..#....#..#....#...+................##
##..#....+..#....+...#................##
.#..#....#..#+####...#..######..####..#.
.#..######.......#####..+....#..+..#..#.
.#......................+....#..#..#..#.
.#..##########+#........+....#..#..#..#.
.#..#..........#........+....#..#..#..#.
.#..############..#..#..######..####..#.
.#....................................#.
.#....................................#.
###################++###################
##................#..#................##
..................#..#..................
................###++###................
................#......#................
................###..###................
